111111111111111111111111
1E0000000000000C00000C01
101001010010000010100101
101001001010101000100101
1C0000000C00C00000000011
111111111101111111111110
11111111110111111111C111
1C0000000000000C00000C01
101000000000000010100101
101111100000111111111101
1P0000000C00C00000000001
111111111111111111111111