111111111111111111111111
1P0000000000000C00000C01
100000000000000000000s01
1C0000000C00C00000000001
100000000000000000011111
1000000000000000000E1111
1C0000000000000C00011111
1000000000000000000000s1
1S0000000000000000000001
100000000C0sC00000000S01
111111111111111111111111