1111111111111111111
1CCCEC1010100C00001
1CCC10000C1C0000001
1CCC1C11111000C0SS1
10111000000000Ps001
100000000C000000001
100000000C00S000001
100000000C000000001
1CCCCCCCCCCCCCCCCC1
1111111111111111111