111111111111111111111111
111P00000000000C00000C01
110000000000000000000s01
1C0000000C00C00000000001
111110000001000000011111
1000000000110000000E1111
1C0011100011000C00011111
1111111000000000000000s1
1S0000000000000000000001
100000000C0sC00000000S01
111110111111110000001111
111000011110111001111111
111111111111111111111111