111111111111111111111111
100CCECC001P01C001C00s01
1110CCC011100110000000s1
11110C0111110100111100s1
1CS0000000010001CC110111
10000000000000010000C0C1
100S0000000000C10001C111
100000011111100100001CC1
100000S0s11s000100001CC1
10000C000000000000000001
111111111111111111111111
111s11ss11s11ss11s11ss11
111111111111111111111111