111111111111111111111
1S00000000111111110P1
10SC000000ssssss01001
100S0C0000s111sC01001
1000000000s1E1s011C01
1111111110ssCss000001
1C00S00C1000000S00001
100000001000C00000C01
10000S0000000000C0001
111111111111111111111