11111111111111111
1S0000000011110P1
10SC00ssssss01001
100S0Cs111sC01001
100000s1E1s011C01
111110ssCss000001
1CSC1000000S00001
10001000C00000C01
10000S000000C0001
11111111111111111