11111111111111111111111111
10000CSs000C0000001P1C0001
111011111s0000110000000001
1CCCCCCCC00000111111111011
111111111C1111111111100011
10000000SC0000000000000001
1CCCCCCCCCCCCCCCE000000001
11111111111111111111111111